1111111111111111111111111111111
1C00000000000000000000000000001
100000000C11100000000C111100001
10P0010000000000C11111000000001
11000110000C1000000000000100001
1C000000000000000000011C1100001
1000011111000000000000000000001
1E000000111100000000C1111100001
11100000000000000C0000000000001
100000000C001111011111111111111
10011000000000000000000000000C1
1001100000000000000C00000000001
1000000000000000111110000100001
1C0000001100010000000111C100101
1000000011110010000000000000111
10000000CC000011100001100000101
100C000110000000C0000000C000001
1111111111111111111111111111111