111111111111
1P000C00C0C1
101111111111
100C00C00C11
101111111111
100C000C0001
10C0C00000E1
111111111111
