1111111111
10101010P1
10C0010001
1100111011
1001000001
1010000011
1010C01011
1010000011
1010000111
10100C0111
1001000001
1010000101
1010100101
1010011111
1000101111
1000000001
10011100E1
1111111111