111111111111111111111111111
1C0000000000000000000000001
100000000C11100000000C11111
10P0010000000000C1111100001
11000110000C100000000000011
1C000000000000000000011C111
100001111100000000000000001
1E000000111100000000C111111
11100000000000000C000000001
100000000C00111101111111111
100110000000000000000000001
1001100000000000000C0000001
100000000000000011111000011
1C0000001100010000000111C11
100000001111001100000000001
10000000CC00001110000110001
100C000110000000C0000000C01
111111111111111111111111111