11111
11P11
100C1
10001
1E0C1
11111