1111111111
11P0000C11
100C000001
10000C0001
1E0C000011
1111111111