111111
1C0E11
100001
11P001
1C0001
111111