1111
1C01
1001
10P1
1101
1001
1C01
1E01
1111