111111111111111111111111111
1C000M00MMM000MM00000000001
100000000C11100000000C11111
10P0010000000000C1111100001
11000110000C100MMMM00000011
1C000000000000000000011C111
100001111100000000000000001
1E000000111100000000C111111
11100000000000000CM0M0M0001
10MM00000C00111101111111111
100110000000000000MM0MM0001
10011M0M0M0M0MMM000C0000001
100000000000000011111000011
1C00M0001100010000000111C11
1000M000111100100MM0MMM0001
1000M000CC00001110000110001
100C000110000000C0000000C01
111111111111111111111111111