111111111111
1000C00000P1
101111111111
1000C0000C11
101111111111
100C0000M001
10M00CM000E1
111111111111
