1111111111
10101010P1
10M00100M1
1100111011
10C10MM001
1010000011
1C100C1011
101MM00011
1C10000111
1010000111
10000M0M01
101E00C101
1110100101
101M001111
1M00101111
1M0C000M01
1001110C11
1111111111