11111
11PM1
100C1
10M01
1E0C1
11111