1111111111
11P0000C11
100C00MM01
1000MC0001
1EMC000C11
1111111111