111111
1CME11
10C0M1
11PM01
1C00M1
111111