1111
1CM1
10M1
10P1
1101
1C01
1001
1E01
1111