111111111111111111111111111111111111111111
11P0000CC00000CCMM00C000000M0M000000M0M001
10000000000000000CC00000000010100000010101
10000C0000000000000000000MM0101000MM010101
1EMMC00CC00000MMMM00000M0000000CM0000000C1
111111111111111111111111111111111111111111