1111111111111111111111111111111111
1E00M0M00MMM000C00000C000000M0M001
1010010100100000101001000000010101
1010M10010101M100010010000MM010101
1P0000000C00C00000000000M0000000C1
1111111111111111111111111111111111