1111111111111
10010000000C1
1000011111001
1P0M11E0000M1
1111111111111