1111111111111
100100C000E01
1000C11111001
1P0011E000001
1111111111111