11111
1P1C1
111E1
1C001
11111
