111111111
10PC01101
10C000C11
111E00001
1C0100001
111111111