111111
101E11
1P0101
1C0001
111111