1111111111111
10010000000C1
10000111110M1

1P0011E0000M1
1111111111111