1111111111111
1M0100C000EM1
1M00C111110M1
1P0011E000001
1111111111111