111111111111
1000C00000P1
101111111111
1000C0000C11
101111111111
100C00000M01
100000110001
10M0C1M100E1
111111111111
