1111111111111
1MM10000000C1
100001111100C
1P0011E0000M1
1111111111111