1111111111111
1MM10000000C1
1000011111001
1P0011E0000M1
111111C111111