1111111111111
1M010000000M1
1000011111001
100011E0000M1
1111111111111