1111111111111
1M010C00000M1
1000011111001
1P001100000M1
1111111111111