1111111111111
1M010000000M1
1000011111001
1P0011E0000M1
1111111111111