111111
1P00M1
111101
1C0E11
111111
