11111
1P1C1
111E1
1C0M1
11111
