111111111
10PC01101
10C00MC11
111E00001
1C01000M1
111111111