111111
101E11
1P0101
1C00M1
111111